#######S###
#   # #   #
#   # ### #
#   # ### #
# ### #   #
#         #
##E########